00000000000000000000
01111111111111111110
01222222222222222210
01233332333323333210
01232222222323223210
01233332223223223210
01222232232223223210
01233332333323333210
01121212121212121210
01121212521212121210
01244442444424444210
01242121212424224210
01244442224224224210
01222242242224224210
01244442444424444210
01232121214212121210
01232121214212121210
01233333224444422210
01222222222222222210
01111111111111111110
